13 13 13 13 13 13 13 13 13 13 13 13 13 13 13 13
13 13 4 4 4 4 4 4 4 4 4 4 4 4 13 13
13 13 0 1 1 1 1 1 2 4 4 4 4 4 13 13
13 13 3 4 4 9 10 4 5 4 4 4 4 4 13 13
13 13 3 4 4 11 11 4 5 4 4 4 4 4 13 13
13 13 3 4 4 11 11 4 5 4 4 4 4 4 13 13
13 13 6 7 7 7 7 7 8 4 4 4 4 4 13 13
13 13 4 4 4 4 4 4 4 4 4 4 4 4 13 13
13 13 4 4 4 4 4 4 4 4 4 4 4 4 13 13
13 13 4 4 4 4 4 4 4 4 4 4 4 4 13 13
13 13 4 4 4 4 4 4 4 4 4 4 4 4 13 13
13 13 13 13 13 13 13 13 13 13 13 13 13 13 13 13
